S,S,S,S,S,+,+,+,+,+,+,+,+,+,+,+,+,+,+,+,+,S,S,S
S,S,S,S,S,+,+,+,+,+,+,+,+,+,+,+,+,+,+,+,+,S,S,S
@,@,@,@,@,@,@,@,+,@,@,@,@,@,@,@,@,@,@,+,+,S,S,S
+,+,+,+,+,+,+,+,+,+,+,+,+,+,+,+,+,+,@,@,@,@,+,@
+,@,G,@,G,@,@,@,+,@,@,@,@,G,G,G,G,+,@,+,+,+,+,@
+,@,G,@,G,@,@,@,+,G,G,G,G,@,@,@,@,+,@,+,@,@,G,@
+,@,G,G,G,@,@,@,+,+,+,+,+,+,+,+,+,+,+,+,@,@,G,@
+,@,@,@,@,@,@,@,+,@,@,@,@,@,@,@,@,@,@,+,@,@,G,@
+,+,+,+,+,+,+,+,+,+,+,+,+,+,+,+,+,+,+,+,@,@,G,@
+,@,@,@,@,@,@,@,+,@,@,@,@,+,@,@,@,@,@,+,@,@,G,@
+,+,+,+,+,+,+,@,+,@,+,+,+,+,+,+,+,G,@,+,@,@,G,@
+,@,@,+,@,@,G,@,+,@,+,@,@,@,@,@,@,G,@,+,@,@,G,@
+,@,@,+,@,@,G,@,+,+,+,@,@,@,@,@,@,G,@,+,+,+,+,@
+,@,@,+,@,@,G,@,+,@,+,@,@,@,@,@,@,G,@,@,@,@,@,@
+,@,@,+,@,@,G,@,+,@,+,G,G,G,G,G,G,G,@,@,@,@,@,@
+,+,+,+,+,+,+,@,+,@,@,@,@,@,@,@,@,@,@,@,@,@,@,@
+,@,@,@,@,@,@,@,+,@,@,@,@,@,@,@,@,@,@,+,S,S,S,S
+,+,+,+,+,+,+,+,+,+,+,+,+,+,+,+,+,+,+,+,S,S,S,S
+,+,+,+,+,+,+,+,+,+,+,+,+,+,+,+,+,+,+,+,S,S,S,S